5,5,5,5,5,5,5,5
5,6,4,4,5,1,7,5
5,4,5,4,1,1,4,5
5,4,5,4,5,4,4,5
5,4,4,4,5,4,5,5
5,4,5,4,5,4,5,5
5,4,5,4,5,4,4,5
5,5,5,4,5,4,5,5
5,4,4,4,4,4,4,5
5,4,5,4,5,4,5,5
5,4,5,4,5,4,4,5
5,5,5,5,5,5,5,5